Java=java
JQuery=jQuery框架
bootstrap=bootstrap框架
j2ee=JavaEE架构
java ee=JavaEE开发
Struts=Struts框架
Hibernate=Hibernate框架
Spring=Spring框架
myBatis=myBatis框架
Ibatis=Ibatis框架
dwr=DWR框架
ExtJS=Extjs框架
Jsf=Jsf框架
EASYUI=EASYUI框架(UI架构)
dwz=dwz框架(UI架构)
spring mvc=spring mvc框架
SpringMVC=spring mvc框架
MyBatis=MyBatis框架
Bootstrap=Bootstrap框架
JAVA框架=JAVA主流框架
myEclipse=myEclipse
jsp=jsp(java服务器页面)
servlet=servlet
javabean=javabean
EJB=EJB
jstl=jstl
css=css层叠样式表
html=Html
php=php
会话控制=会话控制
apache=apache
Nginx=Nginx
Tomcat=Tomcat
weblogic=weblogic服务器
websphere=websphere服务器
jetty=jetty服务器
memcache=memcache
Memcached=Memcached
AJAX=AJAX(异步的JavaScript与XML技术)
ECSHOP=ecshop
ZENCART=zen cart
zen cart=zen cart
Opencart=Opencart
Open cart=Opencart
MAGENTO=MAGENTO
symfony=Symfony框架
FastDFS=FastDFS(一个分布式文件系统)
FreeBSD=FreeBSD操作系统
PHPUnit=PHPUnit单元测试
TFS=TFS(一个分布式文件系统)
ORM=ORM对象关系映射
zend framework2=zend framework2框架
zend framework=zend framework框架
nginx=Nginx(一个HTTP和反向代理服务器)
ThinkPHP=ThinkPHP框架
CodeIgniter=CodeIgniter框架
web2.0=web2.0
XHTML=XHTML
DHTML=DHTML
AOP=AOP面向切面编程
IOC=IOC控制反转
Smarty=Smarty(一个模板引擎)
Photoshop=Photoshop
ps=photoshop
Dreamweaver=Dreamweaver
DW=Dreamweaver
SEO=SEO(搜索引擎优化)
rose=rose(UML画图工具)
eclipse=eclipse
ant=ant(一种基于Java的build工具)
visio=Microsoft Office Visio
C#=C#
.net=.net
ASP.net=.net
asp=.net
dotnet=.net
js=javaScript
javaScript=javaScript
MFC=MFC
visualStudio=visualStudio
visual Studio=visualStudio
多线程=多线程
COM=COM编程
GUI=GUI编程
系统设计=系统设计
系统分析=系统分析
windows=windows操作系统
windows编程=windows编程
windows下编程=windows编程
windows下的编程=windows编程
mysql=mysql数据库
MY SQL=mysql数据库
sql2005=SQL Server数据库
SQL Server=SQL Server数据库
SQLServer=SQL Server数据库
SQL-SERVER=SQL Server数据库
mssql=SQL Server数据库
MS SQL=SQL Server数据库
Oracle=Oracle数据库
NoSQL=NoSQL数据库
Hbase=Hbase数据库
Redis=Redis数据库
PL/SQL=PL/SQL
PLSQL=PL/SQL
PL /SQL=PL/SQL
PL-SQL=PL/SQL
TCP/IP=TCP/IP编程
TCP\IP=TCP/IP编程
TCP、IP=TCP/IP编程
TCP=TCP/IP编程
TCP-UDP=TCP/UDP编程
Socket=Socket编程
WebSocket=WebSocket协议
linux=linux操作系统
unix=unix操作系统
Ubuntu=Ubuntu操作系统
CentOS=CentOS操作系统
Red Hat=Red Hat操作系统
RedHat=Red Hat操作系统
EOS=EOS嵌入式开发
网络编程=网络编程
STL=STL库
boost=boost库
python=python编程
UML=UML建模语言
消息队列=消息队列
共享内存=共享内存
内存共享=共享内存
GDI+=GDI+图形编程
DirectX=DirectX图形编程
OpenGL=OpenGl图形编程
串口=串口编程
usb=usb编程
Qt=Qt
QtCreator=QtCreator开发环境
RTP=RTP传输协议
SIP=SIP协议
RTSP=RTSP传输协议
HTTP=HTTP传输协议
HLS=HLS传输协议
rtmp=rtmp协议
rtcp=rtcp协议
xmpp=xmpp协议
Objective-c=Objective-c语言
Objective c=Objective-c语言
ObjectiveC=Objective-c语言
Swift=Swift语言
XCode=XCode开发工具
svn=svn
vss=vss
github=git
GIT=git
sqlite=sqlite数据库
ios=ios开发
iOS SDK=iOS SDK
iPhone/iPad SDK=iOSSDK
ios平台架构=ios平台架构
UIKIT=UIKIT框架
xml=XML技术
json=jSon技术
OOA=OOA面向对象分析
OOD=OOD面向对象设计
面向对象=面向对象分析
mongodb=MongoDB数据库
Mongo DB=MongoDB数据库
Access=Access数据库
Db2=Db2数据库
sybase=sybase数据库
Cococa SDK=Cococa SDK
Cocoa=Cocoa开发框架
Interface Builder=Interface Builder开发工具
InterfaceBuilder=Interface Builder开发工具
Instruments=Instruments开发工具
Mac OS/iOS相关调试工具=Mac OS/iOS相关调试工具
Mac OS/iOS调试工具=Mac OS/iOS相关调试工具
Ruby On Rails=Ruby On Rails web开发
Prototype=Prototype
redis=redis数据库
Rspec=Rspec(ruby语言的测试插件)
cache=cache技术
ucenter=ucenter(一款开放软件)
uchome=UCenter Home(采用PHP+MYSQL构建的社会化网络软件)
discuz=discuz(一套通用的社区论坛软件系统）
Android SDK=Android SDK
UDP=UDP协议
webview=webview(一个显示网页的视图)
ERP=ERP(企业资源计划)
ViewPager=ViewPager
Fragment=Fragment
网络通信=网络通信
并发控制=并发控制
软件架构=软件架构设计
Android=Android开发
TCP/UDP=TCP/UDP
MySQLit=MySQLit数据库
软件测试=软件测试
操作系统=软件测试
性能测试=软件测试
压力测试=软件测试
接口测试=软件测试
功能测试=软件测试
单元测试=软件测试
兼容性测试=软件测试
回归测试=软件测试
稳定性测试=软件测试
安全性测试=软件测试
易用性测试=软件测试
云服务测试=云服务测试
测试方法=软件测试
B/S软件测试=B/S软件测试
Shell=Shell语言
Perl=Perl语言
自动化测试=自动化测试(使用自动化测试软件、框架等)
白盒测试=软件测试
单元测试工具=单元测试工具
测试用例=软件测试
测试计划=软件测试
测试过程=软件测试
测试报告=软件测试
测试方案=软件测试
测试结果=软件测试
JMeter=JMeter(一个测试软件的工具)
Loadrunner=Loadrunner(一个测试软件的工具)
QTP=QTP(一种自动测试工具)
CVS=CVS(一种自动测试工具)
Mantis=Mantis(一个缺陷跟踪系统)
Bugzilla=Bugzilla(一个开源的缺陷跟踪系统)
Jira=Jira(项目与事务跟踪工具)
web测试工具=web测试工具
测试工具=熟悉主流测试工具
软件工程=软件工程
QC=Quality Center
辅助测试=辅助测试(使用sql语句或者简单的命令查询日志等)
故障定位工具=故障定位工具
脚本语言=熟悉一种脚本语言
软件架构=软件架构
数据库理论=数据库系统原理
数据库理论和应用=数据库系统原理
数据库设计=数据库系统原理
hadoop=hadoop(分布式系统基础架构)
mapreduce=mapreduce(一种编程模型)
netty=netty框架
mina=mina框架
Maven=Maven(一个项目管理工具)
数据分析=数据分析
ETL=ETL(数据仓库技术)
数据结构=数据结构
J2SE=JavaSe
Java se=javaSe
web后端=web后端设计与开发
项目规划=软件项目管理
技术方案=软件项目管理
标书=软件项目管理
项目的管理=软件项目管理
项目管理=软件项目管理
文档撰写=软件文档写作
CorelDRAW=CorelDRAW平面设计软件
Flash=Flash
Illustrator=Adobe Illustrator(AI)
手绘=美工基础
AI=Adobe Illustrator(AI)
美工=美工基础
美术=美术基础
InDesign=Adobe InDesign
bootstrap=Bootstrap(Web前端CSS框架)
fireworks=fireworks
OFFICE=office
办公软件=office
办公工具软件=office
excel=office
powerpoint=office
PPT=office
word=office
project=project
搜索引擎=搜索引擎算法
Axure RP=Axure RP(快速原型设计工具)
AxureRP=Axure RP(快速原型设计工具)
Axure=Axure RP(快速原型设计工具)
SEO=SEO数据挖掘及分析
流量统计工具=流量统计工具
QualityCenter=QualityCenter
qxdm=qxdm高通无线协议分析软
Logcat=Logcat(Android中一个命令行工具)
项目实施=项目实施
bash=bash语言
CXF=CXF
gcc=gcc
g\+\+=g++
c=C语言
c\+\+=C++语言
分布式=分布式
爬虫技术=爬虫技术
Balsamiq=Balsamiq Mockups(快速原型的建立软件)
Pencil=Pencil(手绘风格原型图绘制工具)
3Dmax=3D Studio Max(三维动画渲染和制作软件)
3d max=3D Studio Max(三维动画渲染和制作软件)
3D Studio Max=3D Studio Max(三维动画渲染和制作软件)
maya=Autodesk Maya(三维动画软件)
Autodesk Maya=Autodesk Maya(三维动画软件)
AutodeskMaya=Autodesk Maya(三维动画软件)
mimics=Mimics(医学影像软件)
MAGICS 3D=MAGICS 3D(一款制作3D透视图片的工具)
3D MAGICS=MAGICS 3D(一款制作3D透视图片的工具)
MAGICS3D=MAGICS 3D(一款制作3D透视图片的工具)
cms=cms(Content Management System内容管理系统(网页有关))
django=django框架
postgresql=postgresql
OLAP=Online Analytical Processing
SSIS=Microsoft SQL Server Integration Services
SSAS=Ship Security Alert System
数据挖掘=数据挖掘
SPSS Clementine=SPSS Clementine
SAS EM=SAS EM
SAS/EM=SAS EM
SAS EG=SAS EG
SAS/EG=SAS EG
Mahout=Mahout
机器学习=机器学习
数据库建模=数据库建模
RMAN=Recovery Manager
ODBC=Open Database Connectivity
JDBC=Java Data Base Connectivity
Sybase IQ=Sybase IQ
SybaseIQ=Sybase IQ
GreenPlum=GreenPlum
Teradata=Teradata数据仓库
HDFS=Hadoop分布式文件系统
HBase=HBase
Matlab=Matlab
ITSM=ITSM
ITIL=ITIL
Hive=Hive
Spark=Spark
Arcgis=Arcgis
Mapgis=Mapgis
关系型数据库=关系型数据库
Cognos=Cognos
Goldengate=Goldengate
Sybase ASE=Sybase ASE
SybaseASE=Sybase ASE
ruby=ruby
groovy=groovy
lucenen=lucenen
openfire=openfire
Guava=Guava
Informatica=Informatica
Datastage=Datastage
Erwin=Erwin
Powerdesigner=Powerdesigner
Power designer=Powerdesigner
kettle=kettle
gevent=gevent
gunicom=gunicom
flask=flask
orange=orange
pandas=pandas
tornado=tornado
pyqt=pyqt
Pyramid=Pyramid
Solr=Solr
Pylons=Pylons
防火墙技术=防火墙技术
访问控制技术=访问控制技术
VIM=VIM
emacs=emacs
Twisted=Twisted
sqlalchemy=sqlalchemy
Greenlet=Greenlet
CloudStack=CloudStack
Lua=Lua
VBScript=visual basic script
WCF=Windows Communication Foundation
WebServices=WebService
Webservice=Webservice
Web Services=WebService
amaze=amaze
bootstrap=bootstrap
XSLT=XSLT
Corel DRAW=CorelDRAW
CorelDRAW=CorelDRAW
CDR=CorelDRAW
ActionScript=ActionScript
人机交互=人机交互技术
mindmanager=mindmanager
Mockups=Mockups
ActiveMQ=ActiveMQ
GUIDesign=GUI Design Studio
GUI Design=GUI Design Studio
ODATA=open data protocol
Ehcache=Ehcache
Junit=Junit
soap=soap
rest=rest
Vmware=Vmware
Citrix=Citrix
KVM=Keyboard Video Mouse
中间件=中间件
ESB=Enterprise Service Bus
LinqQ=LinqQ
zookeeper=zookeeper
Netty=Netty
RabbitMQ=RabbitMQ
XenServer=XenServer
hudson=hudson
SOA=SOA
OSGI=Open Service Gateway Initiative
Keepalived=Keepalived
LVS=Linux Virtual Server
Restful=Restful
OAuth=OAuth
SSO=Single Sign On
OWIN=Open Web Interface for .NET
Cassandra=Cassandra数据库
Jedis=Jedis
Jboss=Jboss
Gradle=Gradle
JMS=Java Message Service
webGL=webGL
Storm=Storm
路由协议=路由协议
OSPF=路由协议
BGP=路由协议
VxWorks=VxWorks
WinCE=WinCE
VxLAN=VxLAN
Spine-Leaf=Spine-Leaf
CORBA=CORBA
ArcGIS=ArcGIS
Mapinfo=Mapinfo
GoogleMap=GoogleMap
gdb=gdb
vi=vi
cocos2d-x=cocos2d-x
cocos2d=cocos2d
NDIS=NDIS
FlasCC=FlasCC
cuda=cuda
STL=Standard Template Library
OpenCV=OpenCV
Unity=Unity
wxWidgets=wxWidgets
wxwidget=wxwidgets
HOOK=HOOK
Widbg=Widbg
protobuf=protobuf协议
fix=fix协议
SSH=SSH协议
IDA=IDA
OllyDBG=OllyDBG
GDB=GDB
VC\+\+=Microsoft Visual C++ 6.0
VC=Microsoft Visual C++ 6.0
C\+\+builder=C\+\+builder
WinSock=WinSock
串口=串口开发
JBPM=JBPM
activiti=activiti
Sencha Touch=Sencha Touch
iWebkit=iWebkit
DOM=DOM
BOM=BOM
CommonJS=CommonJS
MobileWeb=MobileWeb
jQuery Mobile=jQuery Mobile
Backbone=Backbone
离散结构=离散结构
数字逻辑=数字逻辑
计算机组成原理=计算机组成原理
计算机网络=计算机网络
编译原理=编译原理
微机原理=微机原理与接口技术
形式语言与自动机理论=形式语言与自动机理论
单片机=单片机原理与引用
嵌入式=嵌入式操作系统
多媒体技术=多媒体技术
网络交换与路由协议=网络交换与路由协议
无线传感网络=无线传感网络
网站规划与技术=网站规划与技术
电子商务与安全=电子商务与安全
无线网络攻防=无线网络攻防
管理学原理=管理学原理
管理信息系统=管理信息系统
电子商务=电子商务
商务智能方法及应用=商务智能方法及应用
信息检索=信息检索
编译原理=编译原理
算法设计=算法设计与技术
算法分析=算法设计与技术
算法设计与分析=算法设计与技术
三维造型与动画技术=三维造型与动画技术
网络安全=网络安全技术
信息安全=信息安全导论
汇编语言=汇编语言
汇编=汇编语言
密码学=密码学
网络信息对抗=网络信息对抗
模糊数学=模糊数学及应用
计算机病毒=计算机病毒与防范
信息隐藏=信息隐藏与恢复
信息恢复=信息隐藏与恢复
信息安全工程与管理=信息安全工程与管理
数字媒体技术=数字媒体技术导论
3D图形程序设计=3D图形程序设计
多媒体画面技术=多媒体画面技术
游戏架构设计=游戏架构设计
计算机图形学=计算机图形学
数字图形处理=数字图形处理
虚拟现实技术=虚拟现实技术
三维造型与动画技术=三维造型与动画技术
三维造型=三维造型与动画技术
三维动画=三维造型与动画技术
动画设计=动画设计
游戏设计=游戏设计
多媒体网站=多媒体网站制作
电子商务与安全=电子商务与安全
电路与电子技术=电脑与电子技术基础
数据通信=数据通信基础
网络编程=网络编程
无线通信与网络=无线通信与网络
web数据库=web数据库技术
无线传感网络=无线传感网络
RFID=RFID系统设计
物联网数据处理=物联网数据处理
物联网数据=物联网数据处理
物联网信息安全=物联网信息安全
电子设计硬件描述语言=电子设计硬件描述语言
