Java=java程序设计
JQuery=jQuery框架
bootstrap=bootstrap框架
j2ee=JavaEE架构
java ee=JavaEE开发
Struts=Struts框架
Hibernate=Hibernate框架
Spring=Spring框架
myBatis=myBatis框架
Ibatis=Ibatis框架
dwr=DWR框架
ExtJS=Extjs框架
Jsf=Jsf框架
EASYUI=EASYUI框架(UI架构)
dwz=dwz框架(UI架构)
spring mvc=spring mvc框架
SpringMVC=spring mvc框架
MyBatis=MyBatis框架
JAVA主流框架=JAVA主流框架
JAVA框架=JAVA主流框架
myEclipse=myEclipse
jsp=jsp(java服务器页面)
servlet=servlet
javabean=javabean
EJB=EJB
jstl=jstl
css=css层叠样式表
html=Html
php=php开发设计
会话控制=会话控制
apache=apache
Nginx=Nginx
Tomcat=Tomcat
weblogic=weblogic服务器
websphere=websphere服务器
jetty=jetty服务器
memcached=memcached分布式的快取系统
AJAX=AJAX(异步的JavaScript与XML技术)
ECSHOP=ecshop
ZENCART=zen cart
zen cart=zen cart
Opencart=Opencart
Open cart=Opencart
MAGENTO=MAGENTO
symfony=Symfony(基于MVC模式的面向对象的PHP5框架)
FastDFS=FastDFS(一个开源的轻量级分布式文件系统)
FreeBSD=FreeBSD(一种类UNIX操作系统)
PHPUnit=PHPUnit单元测试
TFS=TFS(是一个高可扩展、高可用、高性能、面向互联网服务的分布式文件系统)
ORM=ORM对象关系映射
mvc=MVC框架
zend framework2=zend framework2(完全基于PHP5的开源PHP开发框架)
zend framework=zend framework(完全基于PHP5的开源PHP开发框架)
nginx=Nginx(("engine x")是一个高性能的HTTP和反向代理服务器)
ThinkPHP=ThinkPHP(一个快速、兼容而且简单的轻量级国产PHP开发框架)
CodeIgniter=CodeIgniter(一套给PHP网站开发者使用的应用程序开发框架和工具包)
web2.0=web2.0
XHTML=XHTML
DHTML=DHTML
AOP=AOP面向切面编程
IOC=IOC控制反转
Smarty=Smarty(一个使用PHP写出来的模板引擎)
Photoshop=Photoshop
ps=photoshop
Dreamweaver=Dreamweaver
SEO=SEO(搜索引擎优化)
rose=rose(UML画图工具)
eclipse=eclipse
ant=ant(一种基于Java的build工具)
visio=Microsoft Office Visio
C#=C#语言
.net=.net
js=javaScript脚本语言
javaScript=javaScript脚本语言
MFC=MFC
visualStudio=visualStudio
visual Studio=visualStudio
多线程=多线程
COM=COM编程
GUI=GUI编程
系统设计=系统设计
系统分析=系统分析
windows=windows操作系统
windows编程=windows编程
windows下编程=windows编程
windows下的编程=windows编程
mysql=mysql数据库
SQL Server=SQL Server数据库
SQLServer=SQL Server数据库
mssql=SQL Server数据库
Oracle=Oracle数据库
Hbase=Hbase数据库
PL/SQL=过程化sql语言
PLSQL=过程化sql语言
TCP/IP=TCP/IP编程
TCP\IP=TCP/IP编程
TCP、IP=TCP/IP编程
Socket=Socket编程
WebSocket=WebSocket协议
linux=linux操作系统
unix=unix操作系统
Ubuntu=Ubuntu操作系统
CentOS=CentOS操作系统
Red Hat=Red Hat操作系统
RedHat=Red Hat操作系统
EOS=EOS嵌入式操作系统
网络编程=网络编程
STL=STL库
boost=boost库
python=python编程
UML=UML建模语言
消息队列=消息队列
共享内存=共享内存
内存共享=共享内存
GDI+=GDI+图形编程
DirectX=DirectX图形编程
OpenGL=OpenGl图形编程
串口=串口编程
usb=usb编程
Qt=Qt
QtCreator=QtCreator开发环境
RTP=RTP传输协议
RTSP=RTSP传输协议
HTTP=HTTP传输协议
HLS=HLS传输协议
xmpp=xmpp协议
Objective-c=Objective-c语言
Objective c=Objective-c语言
ObjectiveC=Objective-c语言
Swift=Swift语言
XCode=XCode开发工具
svn=svn版本控制系统
github=github版本控制系统
GIT=github版本控制系统
sqlite=sqlite数据库
iOS SDK=iOS SDK
iPhone/iPad SDK=iOSSDK
ios平台架构=ios平台架构
UIKIT=UIKIT框架
xml=XML技术
json=jSon技术
OOA=OOA面向对象分析
OOD=OOD面向对象设计
mongodb=Mongo DB数据库
Mongo DB=Mongo DB数据库
Access=Access数据库
Db2=Db2数据库
sybase=sybase数据库
Cococa SDK=Cococa SDK
Cocoa=Cocoa开发框架
Interface Builder=Interface Builder开发工具
InterfaceBuilder=Interface Builder开发工具
Instruments=Instruments开发工具
Mac OS/iOS相关调试工具=Mac OS/iOS相关调试工具
Mac OS/iOS调试工具=Mac OS/iOS相关调试工具
Ruby On Rails=Ruby On Rails web开发
Prototype=Prototype
redis=redis数据库
Rspec=Rspec是ruby语言中的一种测试插件
cache=cache技术
ucenter=ucenter(一款开放软件)
uchome=UCenter Home(是一套采用PHP+MYSQL构建的社会化网络软件)
discuz=discuz
Android SDK=Android SDK
UDP=UDP
webview=webview(一个显示网页的视图)
ERP=ERP(企业资源计划)
ViewPager=ViewPager
Fragment=Fragment
网络通信=网络通信
并发控制=并发控制
软件架构=软件架构设计
Android=Android开发
TCP/UDP=TCP/UDP
MySQLit=MySQLit数据库
软件测试=软件测试
操作系统=软件测试
性能测试=软件测试
压力测试=软件测试
接口测试=软件测试
功能测试=软件测试
单元测试=软件测试
兼容性测试=软件测试
回归测试=软件测试
稳定性测试=软件测试
安全性测试=软件测试
易用性测试=软件测试
云服务测试=云服务测试
测试方法=软件测试
B/S软件测试=B/S软件测试
Shell=Shell语言
Perl=Perl语言
自动化测试=自动化测试(使用自动化测试软件、框架等)
白盒测试=白盒测试
单元测试工具=单元测试工具
测试用例=测试用例(设计和执行等)
测试计划=制定测试计划
测试过程=测试过程(熟悉、执行等)
测试报告=完成测试报告
测试方案=测试方案(编写和评估等)
测试结果=分析测试结果
JMeter=JMeter(一个测试软件的工具)
Loadrunner=Loadrunner(一个测试软件的工具)
QTP=QTP(一种自动测试工具)
CVS=CVS(一种自动测试工具)
Mantis=Mantis(一个基于PHP技术的轻量级的开源缺陷跟踪系统)
Bugzilla=Bugzilla(一个开源的缺陷跟踪系统)
Jira=Jira(Atlassian公司出品的项目与事务跟踪工具)
web测试工具=web测试工具
测试工具=熟悉主流测试工具
软件工程=软件工程
QC=Quality Center
辅助测试=辅助测试(使用sql语句或者简单的命令查询日志等)
故障定位工具=故障定位工具
脚本语言=熟悉一种脚本语言
软件架构=软件架构
数据库理论=数据库理论和应用
数据库理论和应用=数据库理论和应用
数据库设计原理=数据库设计原理
hadoop=hadoop(分布式系统基础架构)
mapreduce=mapreduce(一种编程模型)
netty=netty框架
mina=mina框架
Maven=Maven(是一个项目管理工具)
数据分析=数据分析
ETL=ETL(数据仓库技术)
数据结构=数据结构
J2SE=JavaSe
Java se=javaSe
web后端=web后端设计与开发
项目规划=编写项目规划
技术方案=编写技术方案
标书=编写标书
项目的管理=软件项目管理
项目管理=软件项目管理
文档撰写=软件文档写作
CorelDRAW=CorelDRAW平面设计软件
Flash=Flash
Illustrator=Adobe Illustrator(AI)
手绘=会手绘
AI=Adobe Illustrator(AI)
美工设计=美工设计基础
美术功底=扎实的美术功底
InDesign=Adobe InDesign
bootstrap=Bootstrap(Web前端CSS框架)
fireworks=fireworks
OFFICE=OFFICE办公软件
办公软件=OFFICE办公软件
搜索引擎算法=搜索引擎算法
Axure RP=Axure RP(是一个专业的快速原型设计工具)
AxureRP=Axure RP(是一个专业的快速原型设计工具)
SEO数据挖掘及分析=SEO数据挖掘及分析
流量统计工具=流量统计工具
QualityCenter=QualityCenter
qxdm=qxdm高通无线协议分析软
Logcat=Logcat(Android中一个命令行工具)
项目实施=项目实施
bash=bash语言
CXF=CXF
gcc=gcc
g\+\+=g++
c=C语言
c\+\+=C++语言
分布式系统=分布式系统
Balsamiq=Balsamiq Mockups(一种软件工程中快速原型的建立软件)
Pencil=Pencil(一款开源的手绘风格原型图绘制工具)
3Dmax=3D Studio Max(三维动画渲染和制作软件)
3d max=3D Studio Max(三维动画渲染和制作软件)
3D Studio Max=3D Studio Max(三维动画渲染和制作软件)
maya=Autodesk Maya(三维动画软件)
Autodesk Maya=Autodesk Maya(三维动画软件)
AutodeskMaya=Autodesk Maya(三维动画软件)
mimics=Mimics(医学影像软件)
MAGICS 3D=MAGICS 3D(一款制作3D透视图片的工具)
3D MAGICS=MAGICS 3D(一款制作3D透视图片的工具)
MAGICS3D=MAGICS 3D(一款制作3D透视图片的工具)
cms=cms(Content Management System内容管理系统(网页有关))
django=django框架
postgresql=postgresql
